+++++++++++++++++++++++++++++++++++++++++++++++++++++++++++++++++++++++++++++++++++++++++++++++++++++

HOMEWORK 1:

BitOperator: Побитовые операции;

Priority: Приоритетность операторов;

MathExperiments: Изучить библиотеку (класс) Math из jdk;

EvenOddNumber: Определить нечётное число;
Average: Среди трёх чисел найти среднее;
Divisibility: Проверка делимости одного числа на другое;
KbConvert: Перевести байты в килобайты или наоборот;
LetterOrOther: Буква или иной символ;
LeapYear: Определить високосный год или нет

SleepOrNot: Создать СТАТИЧЕСКИЙ метод sleepIn рядом с методом main;

EqualNames: Запросить у пользователя через консоль его имя;

PhoneNumber: Создать СТАТИЧЕСКИЙ метод createPhoneNumber.

+++++++++++++++++++++++++++++++++++++++++++++++++++++++++++++++++++++++++++++++++++++++++++++++++++++

HOMEWORK 2:

arrays:
    NumFromConsole: Проверка на ввод целого числа;

loop:
    Exponentiation: Возведение числа в заданную степень;
    Multiply: Вычисление факториала;
    MultiplyRecursion: Рекурсивный метод вычисления факториала;
    Multitable: Таблица умножения;
    Overflow: Переполнение буфера;
    Presentation: Методы их презентации.

utils:
    ArrayUtils: Генерация и вывод элементов массива заданного
                через консоль размера массива. Вывод: все элементы массива,
                каждый второй элемент массива, массив в обратном порядке.
    PresentationArrayUtils: evenSumm: Сумма четных положительных элементов массива
                            	evenMax: Максимальный из элементов массива с четными индексами
                            	loAverage: Элементы массива, которые меньше среднего арифметического
                            	twoLow: Найти два наименьших (минимальных) элемента массива
                            	arrayCompress: Сжать массив, удалив элементы, принадлежащие интервалу
                            	sumNum: Сумма цифр массива

+++++++++++++++++++++++++++++++++++++++++++++++++++++++++++++++++++++++++++++++++++++++++++++++++++++

HOMEWORK 3:

